000000000
000000000
000000000
100000001
100000000
000000001
000000003
300000000
000000002
000000002
000000001
200000000
200000000
100000000
000000000
000022000
000220000
000101000
002000200
000222000
010111010
200000000
020000000
202000000
020200000
002020000
000202000
000020200
000002020
000000202
000000020
000000002
100000000
000000000
000000000