0000000000
0000000000
2000000000
0200000000
0020000000
0000000002
0000000020
0000000200
0000000000
3000000003
2000000002
0400000000
0000000040
1002002001
2000000000
0200000000
2020000000
0202000000
0030000001
0000000002
0000000020
0000000202
0000000030
2020202020
0202020202
3003003003
1000000001
0200000020
0020000200
0003003000
0200330020
0000000000
0000000000
0000000000
